14	26	8	23	10	19	12	13	9	1	2	20	2	19	16	29
9	10	23	1	6	2	9	28	23	8	16	16	29	2	24	28
7	29	9	23	19	21	1	26	2	29	12	14	11	7	15	7
19	19	20	11	3	29	0	0	8	-1	6	5	23	21	20	4
16	11	11	19	19	-1	15	18	5	-1	0	24	21	15	13	14
1	23	7	28	20	-1	-1	-1	-1	-1	3	5	21	15	9	10
3	29	11	21	24	14	23	0	29	26	20	29	15	6	18	4
11	3	6	3	20	19	20	20	25	14	10	20	14	25	29	26
9	4	8	9	2	20	21	21	29	28	3	-1	24	-1	28	20